32
24
0 0 0 0 0 0 0 0 0 0 0 0 0 0 0 0 0 0 0 0 0 0 0 0 0 0 0 0 0 0 0 0 
0 0 0 0 0 0 0 0 0 0 0 0 0 0 0 0 0 0 0 0 0 0 0 0 0 0 0 0 0 0 0 0 
0 0 0 0 0 0 0 0 0 0 0 0 0 0 0 0 0 0 0 0 0 0 0 0 0 0 202 0 0 0 0 0 
0 0 0 0 0 0 0 0 0 0 0 0 0 0 0 0 0 0 0 0 0 0 0 0 0 0 0 0 0 0 0 0 
0 0 0 0 0 0 0 0 0 0 0 0 0 0 0 0 0 0 0 0 0 0 0 0 0 0 300 0 301 0 0 0 
0 0 0 0 0 0 0 0 0 0 0 0 0 202 0 0 0 0 0 0 0 0 0 0 0 0 0 0 0 0 0 0 
0 0 0 0 0 0 0 0 0 0 0 0 0 0 0 0 0 0 0 0 12 10 2 2 10 10 10 10 13 0 0 0 
0 0 0 0 0 0 0 0 0 0 0 0 0 0 0 0 0 0 0 12 11 11 11 11 11 11 11 0 0 0 0 0 
0 0 0 0 12 10 10 10 10 3 3 3 10 10 10 3 3 3 10 11 0 0 0 0 0 0 0 0 0 0 0 0 
0 0 0 0 0 0 0 0 0 0 0 0 0 0 0 0 0 0 0 0 0 0 200 0 0 0 0 0 0 0 0 0 
13 0 0 0 0 0 0 0 0 0 0 0 0 0 0 0 0 0 0 0 0 0 0 0 0 0 0 0 0 0 0 0 
11 10 10 10 10 10 10 10 10 10 10 10 10 10 10 10 10 13 0 0 0 0 0 0 0 0 0 0 0 0 0 0 
0 0 0 0 0 0 0 0 0 0 0 0 0 0 0 0 0 11 10 10 10 10 10 10 10 10 10 10 13 0 0 0 
0 0 0 0 0 0 0 0 0 0 0 0 0 0 0 0 0 0 0 0 0 0 0 0 0 0 0 0 0 0 0 0 
0 0 0 12 10 10 10 10 10 10 10 10 10 10 10 10 13 0 0 0 0 0 0 0 0 0 0 0 0 0 12 10 
0 0 0 0 0 0 0 0 201 0 0 0 0 0 0 0 11 10 10 10 10 10 10 10 10 10 10 10 10 10 11 11 
13 0 0 0 0 0 0 0 0 0 0 0 0 0 0 0 0 0 0 0 0 0 0 0 0 0 0 0 0 0 0 11 
11 10 10 10 10 10 10 10 10 10 10 10 10 10 13 0 0 0 0 0 0 0 0 0 0 0 0 0 0 0 0 0 
0 0 100 0 0 0 0 0 0 0 0 0 0 11 11 13 0 0 0 0 0 0 0 0 0 0 0 0 0 0 0 0 
0 0 0 0 0 0 0 0 0 0 0 0 0 0 11 11 10 10 10 10 10 10 10 10 10 10 10 10 13 0 0 0 
10 10 10 13 0 0 0 0 0 0 0 0 0 0 0 0 0 203 0 0 0 0 0 204 0 0 0 0 0 0 0 0 
0 0 101 0 0 0 0 0 0 0 0 0 0 0 0 0 0 0 0 0 0 0 0 0 0 0 0 0 0 0 0 0 
0 0 0 0 0 0 0 0 0 200 0 0 0 0 0 0 0 0 0 0 0 0 0 0 0 0 0 0 0 0 12 10 
10 10 10 10 10 10 10 10 10 10 10 10 10 10 10 10 2 2 2 10 10 10 1 1 1 10 10 10 10 10 11 11 
2
Switch 6 12 3 8 16 0 14
Button 4 0 15 3 22 14 22 11 29 12

Switch int switchType, int laserType, int laserSize, int state, int switchX,int switchY, int laserX, int laserY

Button int buttonOneType,int buttonTwoType, int laserType, int state, int buttonOneX, int buttonOneY, int buttonTwoX, int buttonTwoY, int laserX, int laserY


100 - buoy
101 - grill
200 - bronze coin
201 - silver coin
202 - gold coin
203 - Red diamond
204 - blue diamond
300 - red door
301 - blue door