32
24
0 0 0 0 0 0 0 0 0 0 0 0 0 0 0 0 0 0 0 0 0 0 0 0 0 0 0 0 0 0 0 0 
301 300 0 0 0 0 0 0 0 0 0 0 0 0 0 0 0 0 0 0 0 0 0 0 0 0 0 0 0 0 0 0 
0 0 0 0 0 0 0 0 0 0 0 0 0 0 0 0 0 0 0 0 0 0 0 0 0 0 0 0 0 0 0 0 
10 10 10 10 10 13 0 0 0 0 0 12 10 10 10 10 10 10 13 0 0 0 0 0 0 0 0 0 0 0 0 0 
0 0 0 0 0 11 0 0 0 0 0 11 0 0 0 0 0 0 0 10 0 0 0 0 0 0 0 0 0 0 0 0 
0 0 0 0 0 11 3 13 0 0 3 11 0 0 0 0 0 0 0 0 10 0 0 0 0 0 0 0 0 0 0 0 
0 0 0 0 0 0 11 0 0 0 11 0 0 0 0 0 0 0 0 0 11 0 0 0 0 0 0 0 0 0 0 0 
0 0 0 0 0 0 11 0 0 12 11 0 0 0 0 0 10 0 0 0 0 10 0 0 0 0 0 0 0 0 0 0 
0 0 0 0 0 0 11 204 0 203 11 0 0 0 0 0 0 0 0 0 0 0 10 10 10 10 13 0 0 0 0 0 
0 0 0 0 0 0 11 10 10 10 11 0 0 0 0 0 0 12 13 0 0 0 0 0 0 0 0 0 0 0 0 0 
0 0 0 0 0 0 0 0 0 0 0 0 0 0 0 0 0 0 0 10 0 0 0 0 0 0 0 0 0 12 10 10 
0 0 0 0 0 0 0 0 0 0 0 0 0 0 0 0 0 0 0 0 0 0 0 0 0 0 0 0 0 11 0 0 
0 0 0 0 0 0 0 0 0 0 0 0 0 0 0 0 0 0 0 0 0 0 0 0 0 0 0 0 12 11 0 0 
0 0 0 0 0 0 0 0 0 0 0 0 0 0 0 0 0 0 12 10 13 0 0 0 0 0 0 0 11 0 0 0 
0 0 0 12 2 2 10 10 10 1 1 10 10 10 10 3 3 3 11 11 11 3 3 3 10 10 10 10 11 0 0 202 
0 0 0 0 0 0 0 0 0 0 0 0 0 0 0 0 0 0 0 0 0 0 0 0 0 0 0 0 0 0 0 12 
10 13 0 0 0 0 0 0 0 0 0 0 0 0 0 0 0 0 0 0 0 0 0 0 0 0 0 0 0 0 0 0 
11 11 0 0 0 0 0 0 0 0 0 0 0 0 0 0 0 0 0 0 0 0 0 0 0 0 0 0 0 0 0 0 
11 11 10 10 10 10 10 10 10 10 10 10 10 10 10 10 10 10 10 10 10 10 10 10 10 10 10 10 13 0 0 0 
0 0 0 0 0 0 0 0 0 0 0 0 0 0 0 0 0 0 0 0 0 0 0 0 0 0 0 0 0 0 0 0 
0 0 0 0 0 0 0 0 0 0 0 0 0 0 0 0 0 0 0 0 0 0 0 0 0 0 0 0 0 0 0 12 
0 0 100 101 0 0 0 0 0 0 0 0 0 0 0 0 0 0 0 0 0 0 0 0 0 0 0 0 0 0 12 11 
0 0 0 0 0 0 0 0 0 0 0 0 0 0 0 0 0 0 0 0 0 0 0 0 0 0 0 0 0 0 11 11 
10 10 10 10 10 10 10 10 10 10 10 10 10 10 10 10 10 10 10 10 10 10 10 10 10 10 10 10 10 10 11 11 
2
Switch 8 13 5 16 6 27 8
Switch 8 13 5 5 2 6 4


Switch int switchType, int laserType, int laserSize, int state, int switchX, int switchY, int laserX, int laserY
			
Button int buttonType, int laserType, int buttonOneX, int buttonOneY, int buttonTwoX, int buttonTwoY, int laserX, int laserY

100 - buoy
101 - grill
200 - bronze coin
201 - silver coin
202 - gold coin
203 - Red diamond
204 - blue diamaond
300 - red door
301 - blue door