32
24
300 0 0 0 0 0 0 0 0 0 201 0 0 0 0 0 0 0 0 0 0 0 201 0 0 0 0 0 0 0 0 301 
0 0 0 0 0 0 0 0 0 12 10 10 10 13 0 0 0 0 0 0 12 10 10 13 0 0 0 0 0 0 0 0 
10 10 13 0 0 0 0 0 0 0 0 0 0 0 0 0 11 11 0 0 0 0 0 0 0 0 0 0 0 12 10 10 
0 0 0 0 12 3 3 13 0 0 0 0 0 0 0 0 11 11 0 0 0 0 0 0 0 0 12 13 0 0 0 0 
0 0 0 0 0 0 0 0 0 200 0 0 0 0 0 0 11 11 0 0 0 0 0 0 200 0 0 0 0 0 0 0 
0 0 0 0 0 0 0 0 0 10 0 10 0 0 0 0 11 11 0 0 0 0 10 0 10 0 0 0 0 0 0 0 
0 0 0 201 0 0 0 0 0 0 0 0 0 0 0 0 11 11 0 0 0 0 0 0 0 0 0 0 201 0 0 0 
0 0 0 10 0 0 0 0 201 0 0 0 0 0 0 0 11 11 0 0 0 0 0 0 0 201 0 0 10 0 0 0 
202 0 0 0 0 0 0 0 0 0 0 0 12 3 13 0 11 11 0 12 3 13 0 0 0 0 0 0 0 0 0 202 
13 0 0 0 0 0 0 0 10 0 0 0 0 0 0 0 11 11 0 0 0 0 0 0 0 10 0 0 0 0 0 12 
0 0 0 0 0 0 0 0 0 0 0 0 0 0 0 0 11 11 0 0 0 0 0 0 0 0 0 0 0 0 0 0 
0 0 0 0 0 0 0 0 0 0 0 0 0 0 0 12 11 11 13 0 0 0 0 0 0 0 0 0 0 0 0 0 
0 0 0 0 12 13 0 0 0 0 0 12 13 0 0 0 11 11 0 0 12 13 0 0 0 0 0 12 13 0 0 0 
0 0 10 0 0 0 0 0 10 0 0 0 0 0 0 0 11 11 0 0 0 0 0 0 0 10 0 0 0 10 0 0 
0 0 0 0 0 0 0 0 0 0 0 0 0 0 0 0 11 11 0 0 0 0 0 0 0 0 0 0 0 0 0 0 
10 13 0 0 0 0 0 0 202 0 0 0 0 0 0 0 11 11 0 0 0 0 0 0 0 202 0 0 0 0 12 10 
0 0 10 0 0 0 0 0 10 0 0 0 0 0 0 0 11 11 0 0 0 0 0 0 0 10 0 0 0 10 0 0 
0 0 0 10 0 0 0 0 0 0 0 0 0 0 0 0 11 11 0 0 0 0 0 0 0 0 0 0 10 0 0 0 
0 0 0 0 12 10 13 0 0 0 12 10 10 13 0 0 11 11 0 0 12 10 10 13 0 0 0 10 0 0 0 0 
0 0 0 0 0 0 11 1 204 1 11 0 0 0 0 0 11 11 0 0 0 0 0 11 2 203 2 11 0 0 0 0 
0 0 0 0 0 0 0 11 11 11 0 0 0 0 0 12 11 11 13 0 0 0 0 0 11 11 11 0 0 0 0 0 
0 0 0 0 0 0 0 0 0 0 0 0 0 0 0 200 11 11 200 0 0 0 0 0 0 0 0 0 0 0 0 0 
100 0 0 0 0 0 0 0 0 0 0 0 0 0 0 0 11 11 0 0 0 0 0 0 0 0 0 0 0 0 0 101 
10 10 10 10 10 10 10 10 10 10 10 10 10 10 10 10 11 11 10 10 10 10 10 10 10 10 10 10 10 10 10 10 
2
Switch 6 12 3 25 8 7 18
Switch 10 14 3 8 8 24 18

Switch int switchType, int laserType, int laserSize, int state, int switchX,int switchY, int laserX, int laserY
Button int buttonOneType, int buttonTwoType, int laserType, int state, int buttonOneX, int buttonOneY, int buttonTwoX, int buttonTwoY, int laserX, int laserY
100 - buoy
101 - grill
200 - bronze coin
201 - silver coin
202 - gold coin
203 - Red diamond
204 - blue diamond
300 - red door
301 - blue door
