32
24
10 10 10 10 10 10 10 10 10 10 10 10 10 10 10 10 10 10 10 10 10 10 10 10 10 10 10 10 10 10 10 10 
11 0 0 0 0 0 0 0 0 0 0 0 0 0 0 0 0 0 0 0 0 0 0 0 0 0 0 0 0 0 0 11 
11 0 0 0 0 0 0 0 0 0 0 0 0 0 0 100 101 0 0 0 0 0 0 0 0 0 0 0 0 0 0 11 
11 0 0 12 10 10 13 0 0 12 10 10 10 10 10 10 10 10 10 10 10 10 10 10 10 10 10 10 13 0 0 11 
11 13 0 11 0 0 0 0 0 11 0 0 0 0 0 0 0 0 0 0 11 0 0 0 11 0 0 11 0 0 0 11 
11 0 0 11 0 0 0 0 0 11 0 0 0 0 0 0 0 0 0 0 11 0 202 0 11 0 0 11 10 0 0 11 
11 0 0 11 0 0 0 0 0 0 0 12 10 13 0 0 12 10 13 0 11 0 10 0 11 0 11 11 0 0 12 11 
11 0 12 11 0 0 0 0 0 0 0 0 0 11 0 0 11 0 0 0 0 0 11 0 0 0 11 11 0 0 0 11 
11 0 0 11 10 0 0 10 10 13 0 0 0 0 0 0 0 0 0 0 0 0 11 0 0 0 11 11 13 0 0 11 
11 0 0 0 0 0 0 0 0 11 10 10 10 13 0 0 12 10 10 10 10 10 11 10 10 10 11 11 0 0 0 11 
11 13 0 0 0 0 0 0 0 11 0 0 201 11 203 204 11 0 0 0 0 0 0 0 0 0 0 0 0 0 0 11 
11 11 10 13 0 0 0 0 0 0 0 0 0 11 10 10 11 0 0 0 0 0 0 0 0 0 0 0 0 12 10 11 
11 0 11 11 10 10 10 10 10 10 10 10 10 11 11 11 11 0 0 0 0 0 0 0 0 0 12 10 13 11 0 11 
11 0 0 0 0 0 0 0 0 0 0 0 0 0 0 0 0 0 0 0 12 10 10 10 10 13 11 0 0 0 0 11 
11 0 0 0 0 0 0 0 0 0 0 0 0 0 0 0 0 0 0 0 0 0 0 0 0 0 0 0 0 0 0 11 
11 0 0 0 0 0 0 0 0 0 0 0 0 0 0 0 0 0 0 0 0 0 0 0 0 0 0 0 0 0 0 11 
11 0 12 0 10 10 10 13 0 0 12 10 13 0 0 0 0 0 0 12 10 10 10 10 10 10 10 10 10 0 0 11 
11 0 11 0 11 11 0 0 0 0 0 0 11 13 0 200 200 0 12 11 0 0 0 0 11 11 11 11 11 0 0 11 
11 0 11 11 11 0 0 12 10 10 13 0 0 11 10 10 10 10 11 201 0 300 0 0 0 0 11 11 11 0 0 11 
11 0 0 11 0 0 0 0 11 11 0 0 0 0 0 0 0 0 11 13 0 0 0 0 0 0 0 0 11 0 0 11 
11 13 0 0 0 0 0 0 0 0 0 0 0 0 0 0 0 0 0 11 12 10 13 0 0 0 301 0 0 0 0 11 
11 11 13 0 0 0 0 0 12 10 10 10 10 10 10 10 10 13 0 0 0 11 11 10 13 0 0 0 0 0 0 11 
11 11 11 13 0 10 0 10 11 11 11 11 11 11 11 11 11 11 10 13 0 0 11 11 11 10 10 13 0 0 0 11 
11 11 11 11 10 11 10 11 11 11 11 11 11 11 11 11 11 11 11 11 10 10 11 11 11 11 11 11 10 10 10 11 
5
Switch 8 13 2 11 11 29 16
Button 4 0 15 1 4 22 6 22 9 11
Switch 10 14 5 26 5 3 21
Button 4 0 15 2 8 7 7 11 5 8
Switch 6 12 4 3 17 13 8

Switch int switchType, int laserType, int laserSize, int state, int switchX, int switchY, int laserX, int laserY

Button int buttonType, int laserType, int buttonOneX, int buttonOneY, int buttonTwoX, int buttonTwoY, int laserX, int laserY

100 - buoy
101 - grill
200 - bronze coin
201 - silver coin
202 - gold coin
203 - Red diamond
204 - blue diamaond
300 - red door
301 - blue door